...................
.........#.........
.........#.........
........###........
.........#.........
.........#.........
......#######......
.........#.........
.........#.........
.........#.........
.........#.........
........a#b........
